0,1,1,1,1	0,1,1,1,1	0,1,1,1,1	500,1,1,1,2	0,1,2,2,1	0,1,1,1,1	0,1,1,1,1	0,1,1,1,1	0,1,1,1,1	0,1,1,1,1	0,1,1,1,1	0,1,1,1,1	0,1,1,1,1	0,1,1,1,1	0,1,1,1,1	0,1,1,1,1	0,1,1,1,1	0,1,1,1,1	0,1,1,1,1	0,1,1,1,1	0,1,1,1,1	0,1,1,1,1	0,1,1,1,1	0,1,1,1,1	0,1,1,1,1	0,1,1,1,1	0,1,1,1,1	0,1,1,1,1	0,1,1,1,1	0,1,1,1,1	
0,1,1,1,1	0,1,1,1,1	0,1,1,1,1	0,1,1,1,1	0,2,0,1,1	0,1,1,1,1	0,1,2,1,0	505,1,1,0,1	0,1,1,1,1	0,1,1,1,1	0,1,1,1,1	0,1,1,1,1	0,1,1,1,1	0,1,1,1,1	0,1,1,1,1	0,1,1,1,1	0,1,1,1,1	0,1,1,1,1	0,1,1,1,1	0,1,1,1,1	0,1,1,1,1	0,1,1,1,1	0,1,1,1,1	0,1,1,1,1	0,1,1,1,1	0,1,1,1,1	0,1,1,1,1	0,1,1,1,1	0,1,1,1,1	0,1,1,1,1	
0,1,1,1,1	0,1,1,1,1	8,1,1,1,2	0,1,0,2,0	0,0,0,0,0	0,1,0,0,0	0,2,1,0,1	0,1,1,1,1	0,1,1,1,1	0,1,1,1,1	0,1,1,1,1	0,1,1,1,1	0,1,1,1,1	0,1,1,1,1	0,1,1,1,1	0,1,1,1,0	0,1,0,0,1	0,1,1,1,1	0,1,1,1,1	0,1,1,1,1	0,1,1,1,1	0,1,2,1,0	0,1,0,0,0	0,1,0,0,0	510,1,0,0,1	0,1,1,1,1	0,1,1,1,1	0,1,1,1,1	0,1,1,1,1	0,1,1,1,1	
0,1,1,1,1	0,1,1,1,1	0,1,1,1,1	0,0,1,1,0	2,0,0,0,0	0,0,1,0,1	0,1,1,1,1	0,1,1,1,1	0,1,1,1,1	0,1,1,1,1	0,1,1,1,1	0,1,1,1,1	0,1,1,1,1	0,1,1,1,1	0,1,1,1,1	0,1,1,1,1	0,0,0,1,1	0,1,1,1,1	507,1,2,1,1	0,1,1,1,1	0,1,1,1,1	516,2,2,1,2	0,0,0,2,0	0,0,1,0,0	0,0,1,0,1	0,1,1,1,1	0,1,1,1,1	0,1,1,1,1	0,1,1,1,1	0,1,1,1,1	
0,1,1,1,1	0,1,1,1,1	0,1,1,1,1	0,1,1,1,1	0,0,2,1,1	0,1,1,1,1	0,1,1,1,1	0,1,1,1,1	0,1,0,1,0	0,1,0,0,1	0,1,0,1,0	0,1,0,0,1	0,1,1,1,1	0,1,1,1,1	0,1,0,1,2	0,1,2,2,2	0,0,0,2,0	0,1,2,0,0	0,2,0,0,1	0,1,1,1,1	0,1,1,1,1	0,2,0,1,0	0,0,0,0,1	0,1,1,1,1	0,1,1,1,1	0,1,1,1,1	0,1,1,1,1	0,1,1,1,1	0,1,1,1,1	0,1,1,1,1	
0,1,1,1,1	0,1,1,1,1	0,1,1,1,1	0,1,1,1,0	4,2,1,0,0	0,1,1,0,1	0,1,1,1,1	0,1,0,1,0	0,0,0,0,1	0,0,1,1,0	0,0,1,0,1	0,0,0,1,0	0,1,0,0,1	0,1,1,1,1	0,0,2,1,0	0,2,1,0,0	0,0,0,0,2	515,2,1,2,2	0,0,1,2,1	0,1,1,1,1	0,1,1,1,1	0,0,0,1,0	0,0,1,0,2	506,1,1,2,1	0,1,1,1,1	0,1,1,1,1	0,1,0,1,1	0,1,1,1,1	0,1,1,1,1	0,1,1,1,1	
0,1,1,1,1	0,1,1,1,1	0,1,1,1,1	0,1,1,1,1	0,1,1,1,1	0,1,1,1,1	0,1,1,1,1	0,0,0,1,0	0,0,0,0,1	0,1,1,1,1	0,1,1,1,1	0,0,2,1,0	0,0,1,0,1	0,1,1,1,1	508,2,1,1,1	0,1,1,1,1	0,0,0,1,1	0,1,1,1,1	0,1,1,1,1	0,1,1,1,1	0,1,1,1,1	0,0,0,1,1	0,1,1,1,1	0,1,1,1,1	0,1,1,1,1	0,1,1,1,1	0,0,0,1,1	0,1,1,1,1	0,1,1,1,1	0,1,1,1,1	
0,1,1,1,1	0,1,1,1,1	0,1,1,1,1	509,1,1,1,0	0,1,0,0,1	0,1,1,1,1	0,1,1,1,1	2,0,2,1,0	0,0,1,0,2	507,1,1,2,1	0,1,1,1,1	509,2,1,1,1	0,1,1,1,1	0,1,1,1,1	0,1,1,1,1	0,1,1,1,1	0,0,1,1,2	506,1,1,2,1	0,1,1,1,1	0,1,1,1,1	0,1,1,1,1	0,0,1,1,0	0,1,0,0,1	0,1,1,1,1	0,1,0,1,0	0,1,1,0,0	0,0,1,0,0	0,1,0,0,1	0,1,1,1,1	0,1,1,1,1	
0,1,1,1,1	0,1,1,1,1	0,1,1,1,1	0,1,1,1,1	0,0,0,1,3	0,1,0,3,1	0,1,1,1,1	0,2,0,1,1	0,1,1,1,1	0,1,1,1,1	0,1,1,1,1	0,1,1,1,1	0,1,1,1,1	0,1,1,1,1	0,1,1,1,1	0,1,1,1,1	0,1,1,1,1	0,1,1,1,1	0,1,1,1,1	0,1,1,1,1	0,1,1,1,1	0,1,1,1,1	0,0,0,1,0	501,1,1,0,1	0,0,0,1,1	0,1,1,1,1	0,1,1,1,1	0,0,1,1,0	0,1,0,0,1	0,1,1,1,1	
0,1,1,1,1	0,1,1,1,1	0,1,1,1,1	0,1,1,1,1	0,0,0,1,2	0,0,0,2,1	0,1,1,1,1	0,0,0,1,1	0,1,1,1,1	0,1,1,1,1	0,1,1,1,1	0,1,1,1,1	0,1,1,1,1	0,1,1,1,1	0,1,1,1,1	0,1,1,1,1	0,1,1,1,1	0,1,1,1,1	0,1,1,1,1	0,1,1,1,1	0,1,1,1,1	0,1,1,1,0	0,0,1,0,1	0,1,1,1,1	0,0,0,1,1	0,1,1,1,1	0,1,1,1,1	0,1,1,1,1	0,0,0,1,1	0,1,1,1,1	
0,1,1,1,1	0,1,1,1,1	0,1,1,1,1	0,1,1,1,1	2,0,0,1,2	0,0,0,2,1	0,1,1,1,1	0,0,0,1,1	0,1,1,1,1	0,1,0,1,1	0,1,1,1,1	0,1,1,1,1	0,1,1,1,1	0,1,1,1,1	0,1,1,1,1	0,1,1,1,1	0,1,1,1,1	0,1,1,1,1	0,1,1,1,1	0,1,1,1,1	0,1,1,1,1	0,1,1,1,1	0,1,1,1,1	0,1,1,1,1	0,0,0,1,0	0,1,1,0,0	0,1,0,0,0	0,1,1,0,0	0,0,1,0,3	28,1,1,3,1	
0,1,1,1,1	0,1,1,1,1	0,1,1,1,1	0,1,1,1,1	0,0,0,1,2	0,0,0,2,1	0,1,1,1,1	0,0,1,1,0	0,1,1,0,0	0,0,1,0,1	0,1,1,1,1	0,1,1,1,1	0,1,1,1,1	0,1,1,1,1	0,1,1,1,1	0,1,1,1,1	0,1,1,1,1	0,1,1,1,1	0,1,1,1,1	0,1,1,1,1	0,1,1,1,1	0,1,1,1,1	0,1,1,1,1	0,1,1,1,1	0,0,0,1,1	0,1,1,1,1	0,0,0,1,1	0,1,1,1,1	0,1,1,1,1	0,1,1,1,1	
0,1,1,1,1	0,1,1,1,1	0,1,1,1,1	0,1,1,1,1	0,0,0,1,2	0,0,1,2,1	0,1,1,1,1	0,1,1,1,1	0,1,1,1,1	0,1,1,1,1	0,1,1,1,1	511,1,2,1,2	0,1,0,2,1	0,1,1,1,1	0,1,1,1,1	0,1,1,1,1	0,1,1,1,1	0,1,0,1,2	505,1,2,2,1	0,1,1,1,1	0,1,1,1,1	0,1,1,1,1	4,1,1,1,0	0,1,1,0,0	0,0,0,0,1	0,1,1,1,1	0,0,1,1,0	0,1,1,0,0	0,1,0,0,1	0,1,1,1,1	
0,1,1,1,1	0,1,1,1,1	508,1,1,1,0	0,1,0,0,0	0,0,0,0,2	503,2,1,1,1	0,1,1,1,1	0,1,1,1,1	0,1,1,1,1	0,1,1,1,1	0,1,1,1,1	0,2,1,1,0	0,0,1,0,0	0,1,0,0,0	0,1,0,0,0	0,1,0,0,0	0,1,0,0,0	0,0,1,0,0	0,2,1,0,1	0,1,1,1,1	0,1,1,1,1	0,1,1,1,1	0,1,1,1,1	0,1,1,1,1	0,0,0,1,1	0,1,1,1,1	0,1,1,1,1	0,1,1,1,1	0,0,0,1,1	0,1,1,1,1	
0,1,1,1,1	0,1,1,1,1	0,1,1,1,1	0,0,1,1,0	0,0,1,0,1	0,1,1,1,1	0,1,1,1,1	0,1,1,1,1	0,1,1,1,1	0,1,1,1,1	0,1,1,1,1	0,1,1,1,1	0,1,1,1,1	0,0,0,1,0	8,0,0,0,0	8,0,0,0,0	0,0,0,0,1	0,1,1,1,1	0,1,1,1,1	0,1,1,1,1	0,1,1,1,1	0,1,1,1,1	0,1,1,1,1	0,1,1,1,1	0,0,1,1,0	0,1,1,0,0	0,1,0,0,0	0,1,1,0,0	0,0,1,0,1	0,1,1,1,1	
0,1,1,1,1	0,1,1,1,1	0,1,1,1,1	0,1,1,1,1	0,1,1,1,1	0,1,1,1,1	0,1,1,1,1	0,1,1,1,1	0,1,1,1,1	0,1,1,1,1	0,1,1,1,1	0,1,1,1,1	0,1,0,1,0	0,0,2,0,0	0,0,0,0,0	0,0,0,0,0	0,0,1,0,0	0,1,0,0,1	0,1,1,1,1	0,1,1,1,1	0,1,1,1,1	0,1,1,1,1	0,1,1,1,1	0,1,1,1,1	0,1,1,1,1	0,1,1,1,1	0,0,0,1,1	0,1,1,1,1	0,1,1,1,1	0,1,1,1,1	
0,1,1,1,1	0,1,1,1,1	0,1,1,1,1	0,1,0,1,0	0,1,0,0,1	0,1,0,1,0	0,1,0,0,2	0,1,0,2,0	0,1,0,0,3	504,1,1,3,1	0,1,1,1,1	2,1,2,1,2	0,0,0,2,1	502,2,2,1,1	0,0,0,1,0	0,0,0,0,2	11,1,1,2,2	0,0,0,2,2	515,1,2,2,1	0,1,1,1,1	0,1,1,1,1	0,1,1,1,1	0,1,1,1,1	0,1,1,1,1	0,1,1,1,1	0,1,1,1,1	0,0,1,1,1	0,1,1,1,1	0,1,1,1,1	0,1,1,1,1	
0,1,1,1,1	0,1,1,1,1	0,1,2,1,0	0,0,1,0,0	0,0,1,0,2	0,0,1,2,0	0,0,2,0,1	0,0,1,1,0	0,0,1,0,2	0,1,0,2,1	0,1,1,1,1	0,2,1,1,0	0,0,0,0,0	0,2,0,0,0	0,0,0,0,0	0,0,0,0,0	0,1,0,0,0	0,0,0,0,0	0,2,1,0,1	0,1,1,1,1	0,1,1,1,1	0,1,1,1,1	0,1,1,1,1	0,1,1,1,1	0,1,1,1,1	0,1,1,1,1	0,1,1,1,1	0,1,1,1,1	0,1,1,1,1	0,1,1,1,1	
0,1,1,1,1	0,1,1,1,1	0,2,0,1,2	0,1,1,2,1	515,1,1,1,2	3,1,2,2,1	0,2,0,1,1	506,1,2,1,1	0,1,0,1,1	0,0,0,1,1	0,1,1,1,1	0,1,1,1,1	0,0,1,1,0	0,0,1,0,0	0,0,0,0,0	0,0,0,0,0	0,0,1,0,0	0,0,1,0,1	0,1,1,1,1	0,1,1,1,1	0,1,1,1,1	0,1,1,1,1	0,1,1,1,1	0,1,1,1,1	0,1,1,1,1	0,1,1,1,1	0,1,1,1,1	0,1,1,1,1	0,1,1,1,1	0,1,1,1,1	
0,1,1,1,1	0,1,1,1,1	0,0,0,1,1	0,1,2,1,1	7,1,2,1,2	0,2,0,2,1	0,0,0,1,2	519,2,2,2,2	0,0,1,2,1	0,0,0,1,1	0,1,1,1,1	0,1,1,1,1	0,1,1,1,1	0,1,1,1,1	0,0,1,1,0	0,0,1,0,1	0,1,1,1,1	0,1,1,1,1	0,1,1,1,1	0,1,1,1,1	0,1,1,1,1	0,1,1,1,1	0,1,1,1,1	0,1,1,1,1	0,1,1,1,1	0,1,1,1,1	0,1,1,1,1	0,1,1,1,1	0,1,1,1,1	0,1,1,1,1	
0,1,1,1,1	0,1,1,1,1	0,0,1,1,1	0,2,1,1,0	0,2,1,0,0	0,0,1,0,2	0,0,1,2,0	0,2,1,0,0	0,1,1,0,2	0,0,0,2,1	0,1,1,1,1	0,1,1,1,1	0,1,1,1,1	0,1,1,1,1	0,1,1,1,1	0,1,1,1,1	0,1,1,1,1	0,1,1,1,1	0,1,1,1,1	0,1,1,1,1	8,1,2,1,1	513,1,2,1,1	0,1,1,1,1	0,1,1,1,1	0,1,1,1,1	0,1,1,1,1	0,1,1,1,1	0,1,1,1,1	0,1,1,1,1	0,1,1,1,1	
0,1,1,1,1	0,1,1,1,1	514,1,1,1,2	0,1,0,2,0	0,1,0,0,0	0,1,0,0,1	0,1,0,1,0	0,1,0,0,0	0,1,0,0,2	0,0,0,2,1	0,1,1,1,1	0,1,1,1,1	0,1,1,1,1	0,1,1,1,1	0,1,1,1,1	0,1,1,1,1	0,1,1,1,1	0,1,1,1,1	0,1,1,1,1	0,1,0,1,0	0,2,0,0,0	0,2,0,0,0	0,1,0,0,1	0,1,1,1,1	0,1,1,1,1	0,1,1,1,1	0,1,1,1,1	0,1,1,1,1	0,1,1,1,1	0,1,1,1,1	
0,1,1,1,1	0,1,1,1,1	0,1,1,1,1	0,0,2,1,0	0,0,1,0,0	0,0,0,0,1	0,0,0,1,0	0,0,1,0,0	0,0,0,0,1	0,0,1,1,1	0,1,1,1,1	0,1,1,1,1	0,1,1,1,1	0,1,1,1,1	0,1,1,1,1	0,1,1,1,1	0,1,1,1,1	0,1,1,1,1	0,1,1,1,1	0,0,0,1,0	0,0,1,0,0	0,0,1,0,0	0,0,0,0,1	0,1,1,1,1	0,1,1,1,1	0,1,1,1,1	0,1,1,1,1	0,1,1,1,1	0,1,1,1,1	0,1,1,1,1	
0,1,1,1,1	0,1,1,1,1	0,1,1,1,1	512,2,1,1,1	0,1,1,1,1	0,0,1,1,0	0,0,1,0,1	0,1,1,1,1	0,0,1,1,1	0,1,1,1,1	0,1,1,1,1	0,1,1,1,1	0,1,1,1,1	0,1,1,1,1	0,1,1,1,1	0,1,1,1,1	0,1,1,1,1	0,1,1,1,1	0,1,1,1,1	511,0,1,1,1	0,1,1,1,1	0,1,1,1,1	0,0,0,1,1	0,1,1,1,1	0,1,1,1,1	0,1,1,1,1	0,1,1,1,1	0,1,1,1,1	0,1,1,1,1	0,1,1,1,1	
0,1,1,1,1	0,1,1,1,1	0,1,1,1,1	0,1,1,1,1	0,1,1,1,1	0,1,1,1,1	0,1,1,1,1	0,1,1,1,1	0,1,1,1,1	0,1,1,1,1	0,1,1,1,1	0,1,1,1,1	0,1,1,1,1	0,1,1,1,1	0,1,1,1,1	0,1,1,1,1	0,1,1,1,1	0,1,1,1,1	0,1,1,1,1	0,1,1,1,1	0,1,1,1,1	0,1,0,1,0	0,0,0,0,1	0,1,1,1,1	0,1,1,1,1	0,1,1,1,1	0,1,1,1,1	0,1,1,1,1	0,1,1,1,1	0,1,1,1,1	
0,1,1,1,1	0,1,1,1,1	0,1,1,1,1	0,1,1,1,1	0,1,1,1,1	0,1,1,1,1	0,1,1,1,1	0,1,1,1,1	0,1,1,1,1	0,1,1,1,1	0,1,1,1,1	0,1,1,1,1	0,1,1,1,1	0,1,1,1,1	0,1,1,1,1	0,1,1,1,1	0,1,1,1,1	0,1,1,1,1	0,1,1,1,1	0,1,1,1,1	0,1,0,1,0	0,0,0,0,0	0,0,0,0,1	0,1,1,1,1	0,1,1,1,1	0,1,1,1,1	0,1,1,1,1	0,1,1,1,1	0,1,1,1,1	0,1,1,1,1	
0,1,1,1,1	0,1,1,1,1	0,1,1,1,1	0,1,1,1,1	0,1,1,1,1	0,1,1,1,1	0,1,1,1,1	0,1,1,1,1	0,1,1,1,1	0,1,1,1,1	0,1,1,1,1	0,1,1,1,1	0,1,1,1,1	0,1,1,1,1	0,1,1,1,1	0,1,1,1,1	0,1,1,1,1	0,1,1,1,1	0,1,1,1,1	514,1,1,1,2	0,0,1,2,0	0,0,0,0,0	0,0,0,0,1	0,1,1,1,1	0,1,1,1,1	0,1,1,1,1	0,1,1,1,1	0,1,1,1,1	0,1,1,1,1	0,1,1,1,1	
0,1,1,1,1	0,1,1,1,1	0,1,1,1,1	0,1,1,1,1	0,1,1,1,1	0,1,1,1,1	0,1,1,1,1	0,1,1,1,1	0,1,1,1,1	0,1,1,1,1	506,1,1,1,2	0,1,1,2,0	0,1,1,0,0	0,1,1,0,0	0,1,1,0,0	517,1,1,0,2	518,1,1,2,0	0,1,1,0,0	0,1,2,0,0	0,1,1,0,0	5,1,1,0,1	0,0,1,1,0	0,0,1,0,1	0,1,1,1,1	0,1,1,1,1	0,1,1,1,1	0,1,1,1,1	0,1,1,1,1	0,1,1,1,1	0,1,1,1,1	
0,1,1,1,1	0,1,1,1,1	0,1,1,1,1	0,1,1,1,1	0,1,1,1,1	0,1,1,1,1	0,1,1,1,1	0,1,1,1,1	0,1,1,1,1	0,1,1,1,1	0,1,1,1,1	0,1,1,1,1	0,1,1,1,1	0,1,1,1,1	0,1,1,1,1	0,1,1,1,1	0,1,1,1,1	0,1,1,1,1	7,2,1,1,1	0,1,1,1,1	0,1,1,1,1	0,1,1,1,1	0,1,1,1,1	0,1,1,1,1	0,1,1,1,1	0,1,1,1,1	0,1,1,1,1	0,1,1,1,1	0,1,1,1,1	0,1,1,1,1	
0,1,1,1,1	0,1,1,1,1	0,1,1,1,1	0,1,1,1,1	0,1,1,1,1	0,1,1,1,1	0,1,1,1,1	0,1,1,1,1	0,1,1,1,1	0,1,1,1,1	0,1,1,1,1	0,1,1,1,1	0,1,1,1,1	0,1,1,1,1	0,1,1,1,1	0,1,1,1,1	0,1,1,1,1	0,1,1,1,1	0,1,1,1,1	0,1,1,1,1	0,1,1,1,1	0,1,1,1,1	0,1,1,1,1	0,1,1,1,1	0,1,1,1,1	0,1,1,1,1	0,1,1,1,1	0,1,1,1,1	0,1,1,1,1	0,1,1,1,1	
